0,0,0,1,1,4,1,4,1
0,0,0,1,4,3,4,9,1
0,0,0,1,1,4,1,8,1
0,0,0,1,1,1,4,1,1
1,1,1,1,1,1,4,4,1
1,8,9,8,4,9,1,1,4
1,1,1,1,1,1,1,1,1
6,6,6,6,6,2,6,6,6