13,14,14,14,14,14,15
1,1,2,1,1,1,1
4,4,4,4,4,4,4
1,4,1,1,4,4,4
4,4,1,4,1,4,4
4,4,4,4,3,4,4