5,6,6,6,7
1,1,1,1,8
4,4,4,1,3
1,1,4,1,1
2,1,1,4,1
4,4,1,1,9