5,6,6,6,6,6,6,6,7
1,1,1,1,1,1,1,1,1
1,8,1,8,1,8,1,8,1
1,8,1,8,1,8,1,8,1
1,2,1,8,1,8,1,8,1
1,1,1,1,1,1,1,1,4
0,0,0,0,4,9,4,9,4
0,0,0,0,1,1,1,1,1
0,0,0,0,1,9,4,9,1
0,0,0,0,1,1,1,1,1
0,0,0,0,1,9,1,9,1
0,0,0,0,1,1,4,1,3

