5,6,6,6,6,6,6,6,7
1,3,1,1,9,1,1,1,9
1,4,1,4,1,4,1,1,1
8,1,4,1,9,4,1,4,1
8,1,1,1,4,1,4,1,9
8,1,4,1,1,4,1,1,2

