5,6,6,6,6,6,6,7
3,1,4,1,1,4,1,1
1,8,1,4,1,1,9,8
9,1,1,4,1,4,1,1
1,4,9,1,8,4,1,1
1,1,8,1,9,2,4,1
1,4,1,9,8,1,4,1
4,1,1,1,1,4,1,1