2,1,1,1,1,1,1
1,0,0,1,0,0,1
6,1,1,1,0,1,1
1,0,0,5,6,1,0
1,0,1,1,0,1,1
1,1,1,0,0,0,1
3,6,1,1,1,4,1