0,0,0,9,1,1,1
0,0,0,1,1,4,4
1,1,1,1,9,1,1
3,9,8,8,1,4,4
1,8,1,1,4,1,1
0,0,0,4,4,1,1
0,0,0,1,2,1,9