1,4,4,2,4,1,4
1,4,1,4,1,4,1
4,1,4,1,4,1,4
1,4,1,4,1,4,1
1,1,4,1,4,1,1
4,1,4,1,4,4,4
1,1,1,1,1,1,1
6,6,6,11,6,6,6
8,8,1,12,1,9,9
8,8,1,12,1,9,9
8,8,1,12,1,9,9
0,0,0,3,0,0,0