1,1,1,1,1
1,16,8,12,1
1,11,9,2,1
1,15,9,12,1
1,11,9,14,1
1,13,9,12,1
1,11,10,12,1
1,1,3,1,1