5,6,6,6,6,6,6,6,6,7
4,1,4,1,4,1,1,1,2,1
1,8,1,4,1,4,9,4,8,1
9,1,4,1,1,4,1,1,1,1
1,4,1,1,4,1,9,1,9,1
3,8,1,8,1,4,1,1,8,1
9,1,4,1,1,8,9,1,1,1
4,9,8,9,8,4,1,1,9,4