1,1,3,9,1,1,1
4,8,9,1,1,8,1
1,1,9,1,8,2,1
1,4,1,1,8,1,9
1,1,8,9,8,1,1
9,4,8,1,1,9,1
1,1,1,1,1,1,1