5,6,6,6,7
2,1,1,1,1
4,4,4,1,1
1,1,1,1,1
1,4,4,4,1
4,4,3,1,8