1,1,1,10,1,1,1
1,8,1,9,1,8,1
1,10,1,1,1,9,1
3,8,9,1,8,2,1
1,9,1,10,1,1,1
1,1,1,8,9,8,1
1,9,1,1,1,1,1