5,6,6,6,7
1,1,1,1,2
4,4,4,1,1
1,1,1,1,1
1,4,4,4,1
4,4,3,1,8