5,6,6,7,0,0,0,0
4,2,1,1,0,0,0,0
8,9,1,1,0,0,0,0
6,7,1,14,0,0,0,0
1,1,1,1,0,0,0,0
0,0,13,1,5,6,6,7
0,0,1,1,1,1,1,10
0,0,1,1,1,1,1,3