5,6,6,6,6,6,6,6,7
9,2,1,1,1,1,1,1,1
1,8,4,4,4,4,9,8,1
9,1,4,1,1,4,1,1,1
1,4,1,1,4,1,4,1,1
1,8,1,4,1,1,1,4,8
9,1,1,1,1,8,9,1,3