1,4,1,1,9,1
4,4,1,1,1,1
1,1,8,1,9,1
3,1,9,8,2,4
4,4,1,1,4,1
1,4,1,4,4,1
8,1,1,1,1,1